        1111111 1111111 111111111
        100000010011000100000001
        1011000001110000000000001
        1001000000000000000001111
111111111011000001110000000011
10000000001100000111011111111
11110111111111011100000010001
11110111111111011101010010001
1100000011010101110000001001
10000000000000001100000010001
10000000000000001101010010001
110000011101011111011110S011
11110111 1110101 101111010001
11111111 1111111 111111111111