NO ./img/greystone.xpm
SO ./img/purplestone.xpm
WE ./img/redbrick.xpm
EA ./img/wood.xpm

F 190,255,150
C 220,220,255

        1111111111111111111111111
        1000000000110000000000001
        1011000001110000000000001
        1001000000000000000000001
111111111111000000000000111111111
10000000111000000000111111
111101111111110111000000101111
11110111111111011101010010001
10000000000000000000000000001
11000000110101011100000010001
10000000000000001100000010001
100000001000000011010100100N1
11000001 10101011110111100111
11110111 1110101 10111101111
1111111 1111111 111111111111
