NO ./img/greystone.xpm
SO ./img/purplestone.xpm
WE ./img/redbrick.xpm
EA ./img/wood.xpm

F 190,255,150
C 220,220,255

11111111111111
10000000000001
1000000000001
10000000000111
101000000N000S1
11 11111111111